############################################################
############################################################
############################################################
############################################################
############################################################
########             #######################################
###########                       ##########################
############################################################
############################################################
###################################      ###################
#####################                              #########
#####################                              #########
###################                                #########
################                                   #########
############                                       #########
#########                                          #########
#####################                              #########
#####################                              #########
#####################                              #########
#####################                              #########
################  ###                              #########
################  ###                              #########
##############    # #                              #########
###############    ##                              #########
###########         #                              #########
################                                   #########
#####################                              #########
#####################                              #########
############################################################
#####################                              #########
################  ###                              #########
################  ###                              #########
##############    # #                              #########
###############    ##                              #########
###########         #                              #########
################                                   #########
############################################################

