#############################################################
#############################################################
#############################################################
#############################################################
#############################################################
########             ########################################
###########                       ###########################
#############################################################
#############################################################
###################################      ####################
#####################                              ##########
#####################                              ##########
###################                                ##########
################                                   ##########
############                                       ##########
#########                                          ##########
#####################                              ##########
#####################                              ##########
#####################                              ##########
#####################                              ##########
################  ###                              ##########
################  ###                              ##########
##############    # #                              ##########
###############    ##                              ##########
###########         #                              ##########
################                                   ##########
#####################                              ##########
#####################                              ##########
#############################################################
#####################                              ##########
################  ###                              ##########
################  ###                              ##########
##############    # #                              ##########
###############    ##                              ##########
###########         #                              ##########
################                                   ##########
#############################################################
#############################################################
